11111111111111111111111
10000000001000000010101
11111110101011111110101
1P000000100010000000101
11111010111111110110101
10000010000010000010101
10111011111110111011101
1000101010000010101C001
10111010101111101010111
10100000101010000000101
10101111101010000110101
101C1000000010100010101
11101011111010111011101
10001010001010101000001
10101011101110101111111
1010100010100000100C001
10101110101011111011101
101010001000100000000E1
10101011111011101011111
10100010000000001000001
11111111111111111111111